18
*
18
*
1
*
00-1-0
#
01-1-25
#
02-1-27
#
03-1-28
#
04-1-29
#
05-1-58
#
06-1-33
#
07-1-34
#
08-1-35
#
09-1-36
#
10-1-37
#
11-1-11
#
12-1-12
#
13-1-13
#
14-1-14
#
15-1-15
#
16-1-114
#
17-1-115
#
18-1-136
#
19-1-137
#
20-1-16
#
21-1-17
#
22-1-18
#
23-1-38
#
24-1-40
#
25-1-39
#
26-1-60
#
27-1-62
#
28-1-61
#
29-1-92
#
30-1-94
#
31-1-113
#
32-1-117
#
33-1-93
#
34-1-87
#
35-1-88
#
36-1-89
#
37-1-109
#
38-1-110
#
39-1-111
#
40-1-208
#
41-1-209
#
42-1-231
#
43-1-232
*
000000000000000000
001100000000000000
011111000011111111
111111100011111111
111111100001111110
111111100000000000
111111100000000000
111111100001110110
011111000001110110
011111000000000000
000000000000000000
000000000000000000
000000000011111110
111111100011111110
111111100001111100
011111000000000000
000000000000000000
000000000000000000
*
00 00 00 00 00 00 00 00 01 01 00 00 00 00 00 00 00 00
00 00 20 21 22 00 00 00 01 01 00 00 00 00 00 00 00 00
00 20 23 25 40 22 00 00 01 01 00 11 12 13 13 13 14 15 
20 23 26 25 27 40 22 00 01 01 00 06 07 08 08 08 09 10
23 26 26 28 27 27 40 00 01 01 00 00 02 05 02 02 02 00
26 26 29 33 30 27 27 00 01 01 01 01 01 01 01 01 01 01
26 29 33 33 33 30 27 00 01 01 00 00 00 00 00 00 00 00 
31 33 33 33 33 33 32 00 01 01 00 34 35 36 00 40 41 00 
00 03 03 16 17 03 00 00 01 01 00 37 38 39 00 42 43 00
00 04 04 18 19 04 00 00 01 01 00 00 00 00 00 00 00 00
01 01 01 01 01 01 01 01 01 01 00 00 00 00 00 00 00 00 
00 00 00 00 00 00 00 00 01 01 00 00 00 00 00 00 00 00
00 00 00 00 00 00 00 00 01 01 11 12 13 13 13 14 15 00
11 12 13 13 13 14 15 00 01 01 06 07 08 08 08 09 10 00
06 07 08 08 08 09 10 00 01 01 00 02 05 02 02 02 00 00
00 02 05 02 02 02 00 00 01 01 00 00 00 00 00 00 00 00
01 01 01 01 01 01 01 01 01 01 01 01 01 01 01 01 01 01
00 00 00 00 00 00 00 00 01 01 00 00 00 00 00 00 00 00