25
*
25
*
1
*
00-1-0
#
01-1-26
#
03-1-46
#
04-1-47
#
05-1-50
#
06-1-51
#
07-1-48
#
08-1-44
#
09-1-45
#
10-1-70
#
11-1-71
#
12-1-110
#
13-1-112
#
14-1-66
#
15-1-68
#
16-1-69
#
17-1-98
#
18-1-67
#
19-1-111
#
20-1-90
#
21-1-23
#
22-1-22
#
23-1-24
#
24-1-74
#
25-1-72
#
26-1-52
#
27-1-200
#
28-1-201
#
29-1-232
#
30-1-233
#
33-1-27
#
34-1-58
#
35-1-33
#
36-1-34
#
37-1-35
#
38-1-36
#
39-1-37
#
40-1-11
#
41-1-12
#
42-1-13
#
43-1-14
#
44-1-15
*
1110000000000000000000000
1110000000000000000000000
1110000111000000000000000
0000000111000000000000000
0000000111000000000000000
1111000000000000000000000
1111000000000011111111111
0000000000000011111111111
0000000000000011111111111
0011110000000011111111111
0011110000000011111111111
0011110000000000000111110
0011110000000000000000000
0000000000000000000000000
0000000000000000000000000
0000000000000000000000000
0000000000000000000000000
0000000000000000000000000
0000000000000000000000000
0000000000000000000000000
0000000000000001111111111
0000000000000001111111111
0000000000000001111111111
0000000000000001111111111
0000000000000001111111111
*
21 21 26 00 00 00 00 00 00 00 08 09 00 00 01 01 01 01 01 01 01 01 01 01 01
21 21 24 00 00 00 00 00 00 00 03 04 00 00 01 01 01 01 01 01 01 01 01 01 01
22 22 23 00 00 00 00 14 18 15 03 04 00 00 01 01 01 01 01 01 01 01 01 01 01
08 10 10 10 10 10 09 17 00 20 03 04 00 00 01 01 01 01 01 01 01 01 01 01 01
07 11 11 11 11 05 04 12 19 13 03 04 00 00 01 01 01 01 01 01 01 01 01 01 01
25 25 25 26 00 03 06 10 10 10 06 04 00 00 01 01 01 01 01 01 01 01 01 01 01 
22 22 22 23 00 07 11 11 11 11 05 04 00 00 14 18 18 18 18 18 18 18 18 18 15
00 00 00 00 00 00 00 00 00 00 03 04 00 00 17 00 00 00 00 00 00 00 00 00 20
00 00 00 00 00 00 00 00 00 00 03 04 00 00 17 00 00 16 19 19 19 19 19 19 13
01 01 14 18 18 15 01 01 01 00 03 04 00 00 17 00 00 40 41 42 42 42 42 43 44
01 01 17 27 28 20 01 01 01 00 03 04 00 00 12 19 19 35 36 37 37 37 37 38 39
01 01 17 29 30 20 01 01 01 00 03 04 00 00 01 01 01 00 00 33 34 33 33 33 00
01 01 12 19 19 13 01 01 01 00 03 04 00 00 01 01 01 01 01 00 00 00 01 01 01 
01 01 01 01 01 01 01 01 01 00 03 04 00 00 01 01 01 01 01 01 01 01 01 01 01
01 01 01 01 01 01 01 01 01 00 03 04 00 00 01 01 01 01 01 01 01 01 01 01 01
00 00 00 00 00 00 00 00 00 00 03 04 00 00 01 01 01 01 01 01 01 01 01 01 01
00 08 10 10 10 10 10 10 10 10 06 04 00 00 01 01 01 01 01 01 01 01 01 01 01
00 07 11 11 11 11 11 11 11 11 05 04 00 00 01 01 01 01 01 01 01 01 01 01 01
01 01 01 01 01 01 01 01 01 00 03 04 00 00 01 01 01 01 01 01 01 01 01 01 01
01 01 01 01 01 01 01 01 01 00 03 04 00 00 01 01 01 01 01 01 01 01 01 01 01
01 01 01 01 01 01 01 01 01 00 03 04 00 00 01 01 01 01 01 01 01 01 01 01 01
01 01 01 01 01 01 01 01 01 00 00 03 04 00 00 00 14 18 18 18 18 18 18 18 15
01 01 01 01 01 01 01 01 01 00 00 03 04 00 00 00 17 00 00 00 00 00 00 00 20
01 01 01 01 01 01 01 01 01 00 00 03 04 00 00 00 17 00 00 00 00 00 00 00 20
01 01 01 01 01 01 01 01 01 00 00 03 04 00 00 00 17 00 00 00 00 00 00 00 20
01 01 01 01 01 01 01 01 01 00 00 03 04 00 00 00 12 19 19 19 19 19 19 19 13
*
10-23
*
10-0-01.txt
